NO ./textures/North2.xpm
SO ./textures/South2.xpm
EA ./textures/East2.xpm
WE ./textures/West2.xpm

F 100,100,100
C 30,20,255

11111
10001
10N01
11111
